RBWWRBBG
WWWWWWWW
WWBBBWWW
WWRWBWBW
WBBWWWBW
WWBWWBRW
WWWWWBBW
YWWBWWWW